Time;Gols;Vitorias;Empates;Derrotas;Pontos;Aproveitamento;Saldo de Gols;Gols Sofridos
Uruguai;22;8;4;6;28;51.85;0;22
Colombia;20;5;8;5;23;42.59;1;19
Paraguai;12;3;7;8;16;29.63;-14;26
Argentina;27;11;7;0;40;74.07;19;8
Brasil;40;14;4;0;46;85.19;35;5
Chile;18;5;4;9;19;35.19;-7;25
Venezuela;14;3;1;14;10;18.52;-20;34
Peru;17;7;3;8;24;44.44;-5;22
Equador;27;7;5;6;26;48.15;8;19
Bolivia;22;4;3;11;15;27.78;-17;39
